accomplishment	成就
critical	極重要的、關鍵的
fame	名聲、聲譽
foundation	基礎、根基
artistic	藝術的
despite	儘管
multiple	多個的
intelligent	聰明的、智能的
immigrant	移民
hometown	家鄉、故鄉
attraction	有吸引力的事物、景點、吸引力
formation	（岩、雲）層、形成物、結構
form	形成
volcano	火山
gradually	逐漸地
invade	入侵、侵略
circular	圓形的、環狀的
resemble	與...相似、類似
ruin	遺跡、廢墟
found	建立、創立
remain	留下、仍然存在、保持